R 800 600

NO ./textures/brick.xpm
SO ./textures/blue.xpm
WE ./textures/wood.xpm
EA ./textures/grey.xpm
S ./textures/barrel.xpm

F 50,70,80
C 150,100,50

11111111
12000111
111N0001
100000011
11111111