R 800 600

NO ./textures/brick.xpm
SO ./textures/blue.xpm
WE ./textures/wood.xpm
EA ./textures/grey.xpm
S ./textures/barrel.xpm

F 46,65,82
C 143,89,48

        1111111111111111111111111
        1000000000110000002000001
        1011000001110022020002001
        1001002000002000000000001
111111111011000001110022020021111
100000011000001110111100011111
111001111111110111110000000001
111001111111110111110000000101
110000001101010111000000020001
100000000000000011000000000101
100002000000000000000100000001
1100000111010101110011110N0001
11110111 1110101 1011110100001
11111111 1111111 1111111111111