R 800 600

NO ./textures/brick.xpm
SO ./textures/blue.xpm
WE ./textures/wood.xpm
EA ./textures/grey.xpm
S ./textures/barrel.xpm


F 46,65,82
C 143,89,48


111111111111111111111111111111111111111111111111111111111111111111
100000000000000000000000000000000010101010100000000000000002222221
100000000000000000000000000000000010101010100000000000000002222221
100000000000000000000000000000000000000000000000000000000002222221
1000000000000000000000W0000000000000000000000000000000000002222221
100111100000000000000000000000000000000000000000000000000000000001
100111100000000000000000000000000100000000000000200000000000000001
100111100000000000000000100000000100000000000000000000000000000001
100111100000000000000000100000000100000000000000000120000000000001
100111100001111111111111111111000100000000000000000100002000000001
100000000000001000000000100000000100000000000000000100001111111111
100000000000001000000000100000000100000011100000000100000000000001
100000000000001000000000000000000100000011100000000100022221100001
100000000000001000000000000000000100000000000000000100000001000011
100000000000001111110111111111111100000000000000000100200001100001
100000000000001000000100020000000000000000000000000100000001000011
100000000000001000000100000000000000000000000000000100200001100001
100000000000000000000100000000000000002000200000000100000001000011
100000000000000000000000000000002000000000000000000100001101100111
100000000000000000000000000020002000000000000000000100001100000001
100000000000000000000000000000000000020000200000000000001100000111
100000000000000000000000000002000000200000000000000000001100000001
111110000000000000000000000000000000000000000000000000001100000111
111111111111111111111111111111111111111111111111111111111111111111