R 1080 768

NO ./textures/brick.xpm
SO ./textures/blue.xpm
WE ./textures/wood.xpm
EA ./textures/grey.xpm
S ./textures/barrel.xpm

F 220,100,0
C 225,30,0

111111111111111111111111111111111111
100000011111111111111111100000000001
100000011111111111111111100000000001
100000011111111111111111000000000001
100000000000000000000000000000000001
100000000000000000100000000020000001
100000000000000000100000000000000001
100000000000000000000000000000000001
100100000001000000000000000100000001
100100000000100000000000000100000001
100100000000100000000111100010110001
10000S000001000000000000000000000001
100100000000100000000000000000000001
100100000000100000000000000000000001
100100000000100000000000000000000001
100100000000100000000000000000000001
100100000000100000000000000000000001
111111111111111111111111111111111111